***X*X*X*X
*XXX*X*X*X
***X***X*X
XX*XXX*X*X
***X*****X
XX*XXX*XXX
*********X
XX*XXX*XXX
*****X****
XXXXXXXXX*
