***X*****X
*XXX*X*X*X
*****X*X*X
XXXX*XXXXX
*X***X*X*X
*XX*XX***X
*******X*X
XXXX*XXXXX
*****X*X*X
*XXX*X*X*X
*X********