***X*****X
XX***XXXXX
*X*******X
***XXXX**X
*X*X*****X
XX*X*XXX*X
*X*X***X*X
*X*X*X*X*X
***X*X*X*X
XXXXXXXX**