***X*******X
*X*XXXXX*XXX
***********X
*X*XXXXX*XXX
***********X
*X*XXXXX*X*X
***********X
XXXX*X*XXXXX
************
XXXXXXXXXXX*
