***X***X***X
XX*X*XXX*XXX
***X*X*X***X
*X*X*X*X*X*X
*X*******X**
XXXXXXXXXXX*