***********X***X*X*X
XXXX*XXXXX*X*XXX*X*X
*X***X***X*X*******X
*XXX*X*XXX*XXXXXXX*X
*X***X*****X*X***X*X
*XXXXX*X*XXX*XXX*X*X
*******X*X*********X
*XXX*XXXXXXX*XXXXX*X
*X*X*********X*****X
XX*X*XXX*X*XXX*X*X*X
*****X***X*X***X*X*X
XX*XXX*X*XXXXXXX*X*X
***X*X*X*X*****X*X*X
*X*X*X*XXX*X*XXXXX*X
*X***X*****X*****X**
XXXXXXXXXXXXXXXXXXX*
